orang = person
sepeda = bicycle
mobil = car
sepeda motor = motorbike
pesawat = aeroplane
bis = bus
kereta = train
truk = truck
kapal = boat
lampu lalulintas = traffic light
keran kebakaran = fire hydrant
tanda berhenti = stop sign
meteran parkir = parking meter
bangku = bench
burung = bird
kucing = cat
anjing = dog
kuda = horse
domba = sheep
sapi = cow
gajah = elephant
beruang = bear
zebra = zebra
jerapah = giraffe
ransel = backpack
payung = umbrella
tas tangan = handbag
dasi = tie
koper = suitcase
frisbee
ski = skis
snowboard
bola olahraga = sports ball
layang-layang = kite
tongkat pemukul bisbol = baseball bat
sarung tangan bisbol = baseball glove
papan seluncur = skateboard
papan selancar = surfboard
raket tenis = tennis racket
botol = bottle
gelas anggur = wine glass
cangkir = cup
garpu = fork
pisau = knife
sendok = spoon
mangkuk = bowl
pisang = banana
apel = apple
roti isi = sandwich
jeruk = orange
brokoli = broccoli
wortel = carrot
hot dog
pizza
donat = donut
kue = cake
kursi = chair
sofa = sofa
tanaman di dalam pot = pottedplant
kasur = bed
meja makan = diningtable
toilet = toilet
monitor televisi = television monitor
laptop = laptop
tetikus = mouse
remot = remote
papan ketik = keyboard
telepon selular = cell phone
microwave
oven = oven
pemanggang roti = toaster
wastafel = sink
kulkas = refrigerator
buku = book
jam = clock
vas = vase
gunting = scissors
boneka beruang teddy = teddy bear
pengering rambut = hair drier
sikat gigi = toothbrush
